#####################
#####################
#####################
#####################
#####################
#####################
#####################
#####################
#####################
#####################
#####################
#####################
####..........#######
####..........#######
####..........#######
S.##..........###...E
#.##...##.....##..###
#..#...##.....#..####
##.#...##.....#.#####
##.#..........#.#####
##.#..........#.#####
##..............#####
#####################
#####################
#####################
#####################
#####################
#####################
#####################
#####################
#####################
#####################