####################################
#.......................#........###
#.#.....................#........###
#.#.###....###########..#........###
#.#...#..................#.......###
#.#...#...................#......###
#.#...#..........................###
#.#...#..........................###
#.#..........................#...###
#.#...........................#..###
#.#.........######.............#####
#.#.........#....................###
#.#.........#....#...............###
#.#.........#....#...............###
#.#.........#....#...............###
S.#..#...........#...............#.E
###..###....#....#........########.#
###.........###.##...............#.#
###..............................#.#
###..............................#.#
###....##.....................#..#.#
###...#####.................###..#.#
###...#####...................#..#.#
###...#######....#...............#.#
###....#######..#................#.#
###......####..#........#........#.#
###.......###.#.........#........#.#
###........#..#####....###.......#.#
###...........#..................#.#
###...........#..................#.#
###...........#....................#
####################################