############
############
############
############
############
############
############
############
############
############
############
############
#......#...#
#.......#..#
#...#...#..#
S...#...#..E
#...#...#..#
#...#...#..#
#...#......#
#....#.....#
#..........#
############
############
############
############
############
############
############
############
############
############
############