##################################
S.......................#........#
###.....................#........#
###.###....###########..#........#
###...#..................#.......#
###...#...................#......#
###...#..........................#
###...#..........................#
###..........................#...#
###...........................#..#
###.........######.............###
###.........#....................#
###.........#....#...............#
###.........#....#...............#
###.........#....#...............#
###..#...........#...............#
###..###....#....#........########
###.........###.##...............#
###..............................#
###..............................#
###....##.....................#..#
###...#####.................###..#
###...#####...................#..#
###...#######....#...............#
###....#######..#................#
###......####..#........#........#
###.......###.#.........#........#
###........#..#####....###.......#
###...........#..................#
###...........#..................#
###...........#..................E
##################################