############
############
############
############
############
############
############
############
############
############
############
############
############
############
#...#......#
S...#......E
#...#......#
#..........#
#..........#
############
############
############
############
############
############
############
############
############
############
############
############
############