######################
##################...E
##################.###
##################.###
##################.###
##################.###
##################.###
##################.###
##################.###
##################.###
##################.###
##################.###
######...........#.###
######...........#.###
######....#......#.###
S..###....#........###
##..##....#......#####
###..#...#.......#####
####.#...#.......#####
####.#...........#####
####.#......#....#####
####........#....#####
######......#....#####
######...........#####
######...........#####
######...###.....#####
######...........#####
######...........#####
######################
######################
######################
######################